11111111111111111111111111111111111111111111111111111111111111111111111
1E0000000000000C00000C000000000000000C0C0000000000000000000000000000001
101001010010000010100EE000000000000C000000000000000CCCC0001000000010101
101001001010101000100100000001000000001111111CCC00000000000000000000101
1P0000000C00C00000000000000000000000000000000000000000000000000000000C1
10111111111111100111111111111110111111111111011111111111111111111111101
101001001010101000100100000001000000001111111CCC00000000000000000000101
1C0000000000000C00000C000000000000000C0C0000000000000000000000000000001
11111111111111111111111111111111111111111111111111111111111111111111111