1111111111111
10C100C0000C1
10C03C1111001
1P001CE000C01
1111111111111
